000000000000000000000000000000000000000000000000000000000000004211111300000000000000000000000000000000000000000000000000000000000000000000000000
000000000000000000000000000000000000000411110000000000220000000000110000000000110000000000130000000000100000000000100000000000300000000000000000
000000000000000000000000000000000000000000110000004211110000000000010000000000010000000110011000000111111000000100000000000300000000000000000000
000001100000000004111110000011100110133010100100111112110200011010111100000011100200000000000110000031111110000000000000000000000000000000000000
000000000000000000000000000000000000001100000000011111100000013302100000000112100000000004100000000000000000000000000000000000000000000000000000
000000000000000000000000000000000000000011300000000120300000000111100000000010110000000021410000000011100000000000000000000000000000000000000000
000000000000000000000000000000000000000000130000000000110000000012211000000011111000000002010000000003430000000000000000000000000000000000000000
000000000000000000000000000000000000000333340000001121021000001121121000001100111000000000000000000000000000000000000000000000000000000000000000
000000000000000004110000000312130000000112100000000010000000001211000000011111000000031100000000000000000000000000000000000000000000000000000000
000000000000000000000000000000110000001113320000001240121000000233111000000110011000000000000000000000000000000000000000000000000000000000000000
000000000000000000000000000000000000001100000000001311300000001310100000001121100000000220000000000140000000000000000000000000000000000000000000
000000000000000000000000000000000000000001100000000001100000000112221000000133301000000103331000000122240000000001110000000000000000000000000000
000000000000000000000000000000000000000000000000000000130000000000133100000011211300000011101000000002221000000001400000000000000000000000000000
000000000000000000000000000011000000000012100000000132300000000123210000000132310000000004000000000011000000000011000000000011000000000000000000
000000000000000000000000000000000000000111000000013232411000011232311000000101000000000111000000000000000000000000000000000000000000000000000000
000000000000000000000000000000000000000011000000000031000000000131000000000232000000004232110000001231110000000011000000000000000000000000000000
000000000000000000000000000000000000000001110000000001520000000015451100000013511100000001110000000001100000000000000000000000000000000000000000
000000000000000000000000000000000000000014300000000122510000000110310000000111110000000120110000000011300000000000000000000000000000000000000000
000000000000000000000000000001100000001112110000001155510000001131310000000151511000000055511000000012100000000014100000000000000000000000000000
000000000000000000000000000000000000011100011000012111114000002555552000012333332100011101111100000000001100000000000000000000000000000000000000
000000000000331100000400331110001110331111112210331110101210330000101210000112102110000111201210000112112110000111001110000000000000000000000000
000000000000000000000000001101101110001121101010001101101110003103201100001102301300011101101100010101121100011101401100000000000000000000000000
000000000000000000000000001100111000001112111000002100012000001033301000001033301000012112112100011111014100000000000000000000000000000000000000
000000000000000000000000000000000000000001111000000312001000003321211400003312121000000000011000000000000000000000000000000000000000000000000000
000000000000000000000000000000000000000001101400000011101100000021212100000012001100000012101000003333311000000000000000000000000000000000000000
000000000000000000000000000000000000000041000000000012110000000001010000000301011000000321101000000311121000000000000000000000000000000000000000
000000000000000000000000000000000000000011000000000421000000000021000000000012100000000321100000000332300000000000000000000000000000000000000000
000000000000000000000000000000000000004110000000001220000000001210003000000010003000000011113000000111011000000111000000000000000000000000000000
000000000000000000000000000000000000000000300000000000100000000321200000000004213000000002000000000003000000000000000000000000000000000000000000
